# the forge

MAZE:"forge",' '
GEOMETRY:center,center
#         1         2         3         4         5         6         7 
# 23456789012345678901234567890123456789012345678901234567890123456789012345
MAP
LLLLLLLLLLLLLLLLLLLLLLLLLLLLLLLLLLLLLLLLLLLLLLLLLLLLLLLLLLLLLLLLLLLLLLLLLLLL
LLLLLLLLLLLLLLLLLLLLLLLLLLLLLLLLLLLLLLLLLLLLLLLLLLLLLLLL.......LLLLLLLLLLLLL
LLLLLLLLLLLLLLLLLLLLLLLLLLLLLLLLLLLLLLLLLLLLLLLLLLLLLLL.........LLLLLLLLLLLL
LLLLLLLLLLLLLLLLLLLLLLLLLLLLLLLLLLLLLLLLLLLLLLLLLLLLLLLL.......LLLLLLLLLLLLL
LLLLLLLLLLLLLLLLLLLLLLLLLLLLLLLLLLLLLLLLLLLLLLLLLLLLLLLLLLL.LLLLLLLLLLLLLLLL
LLLLLLLLLLLLLLLLLLLLLLLLLLLLLLLLLLLLLLLLLLLLLLLLLLLLLLLLLLL.LLLLLLLLLLLLLLLL
LLLLLLLLLLLLLLLLLLLLLL...|............LLLLLLLLLLLLLLLLLLLLL.LLLLLLLLLLLLLLLL
LLLLLLLLLLLLLLLLLLLL.....|..............LLLLLLLLLLLLLLLLLLL.LLLLLLLLLLLLLLLL
LLLLLLLLLLLLLLLLLLL..L...|................LLLLLLLLLLLLLLLLL.LLLLLLLLLLLLLLLL
LLLLLLLLLLLLLLLLL........|.................LLLLLLLLLLLLLLLL.LLLLLLLLLLLLLLLL
LLLLLLLLLLLLLLLL............................................LLLLLLLLLLLLLLLL
LLLLLLLLLLLLLLLLL....}...|.................LLLLLLLLLLLLLLLLLLLLLLLLLLLLLLLLL
LLLLLLLLLLLLLLLLLLL......|...............LLLLLLLLLLLLLLLLLLLLLLLLLLLLLLLLLLL
LLLLLLLLLLLLLLLLLLLLL....|..............LLLLLLLLLLLLLLLLLLLLLLLLLLLLLLLLLLLL
LLLLLLLLLLLLLLLLLLLLLLLLLLLLLLLLLLLLLLLLLLLLLLLLLLLLLLLLLLLLLLLLLLLLLLLLLLLL
LLLLLLLLLLLLLLLLLLLLLLLLLLLLLLLLLLLLLLLLLLLLLLLLLLLLLLLLLLLLLLLLLLLLLLLLLLLL
LLLLLLLLLLLLLLLLLLLLLLLLLLLLLLLLLLLLLLLLLLLLLLLLLLLLLLLLLLLLLLLLLLLLLLLLLLLL
LLLLLLLLLLLLLLLLLLLLLLLLLLLLLLLLLLLLLLLLLLLLLLLLLLLLLLLLLLLLLLLLLLLLLLLLLLLL
LLLLLLLLLLLLLLLLLLLLLLLLLLLLLLLLLLLLLLLLLLLLLLLLLLLLLLLLLLLLLLLLLLLLLLLLLLLL
LLLLLLLLLLLLLLLLLLLLLLLLLLLLLLLLLLLLLLLLLLLLLLLLLLLLLLLLLLLLLLLLLLLLLLLLLLLL
ENDMAP

STAIR:(56,02),up
STAIR:(62,02),down

REGION:(00,00,75,19),lit,"ordinary"

MONSTER:'@',"blacksmith",(25,10),"Duri"

MAZE:"forgeX",' '
GEOMETRY:center,center
#         1         2         3         4         5         6         7 
# 23456789012345678901234567890123456789012345678901234567890123456789012345
MAP
LLLLLLLLLLLLLLLLLLLLLLLLLLLLLLLLLLLLLLLLLLLLLLLLLLLLLLLLLLLLLLLLLLLLLLLLLLLL
LLLLLLLLLLLLLLLLLLLLLLLLLLLLLLLLLLLLLLLLLLLLLLLLLLLLLLLL.......LLLLLLLLLLLLL
LLLLLLLLLLLLLLLLLLLLLLLLLLLLLLLLLLLLLLLLLLLLLLLLLLLLLLL.........LLLLLLLLLLLL
LLLLLLLLLLLLLLLLLLLLLLLLLLLLLLLLLLLLLLLLLLLLLLLLLLLLLLLL.......LLLLLLLLLLLLL
LLLLLLLLLLLLLLLLLLLLLLLLLLLLLLLLLLLLLLLLLLLLLLLLLLLLLLLLLLL.LLLLLLLLLLLLLLLL
LLLLLLLLLLLLLLLLLLLLLLLLLLLLLLLLLLLLLLLLLLLLLLLLLLLLLLLLLLL.LLLLLLLLLLLLLLLL
LLLLLLLLLLLLLLLLLLLLLL...|............LLLLLLLLLLLLLLLLLLLLL.LLLLLLLLLLLLLLLL
LLLLLLLLLLLLLLLLLLLL.....|..............LLLLLLLLLLLLLLLLLLL.LLLLLLLLLLLLLLLL
LLLLLLLLLLLLLLLLLLL..L...|................LLLLLLLLLLLLLLLLL.LLLLLLLLLLLLLLLL
LLLLLLLLLLLLLLLLL........|.................LLLLLLLLLLLLLLLL.LLLLLLLLLLLLLLLL
LLLLLLLLLLLLLLLL............................................LLLLLLLLLLLLLLLL
LLLLLLLLLLLLLLLLL....}...|.................LLLLLLLLLLLLLLLLLLLLLLLLLLLLLLLLL
LLLLLLLLLLLLLLLLLLL......|...............LLLLLLLLLLLLLLLLLLLLLLLLLLLLLLLLLLL
LLLLLLLLLLLLLLLLLLLLL....|..............LLLLLLLLLLLLLLLLLLLLLLLLLLLLLLLLLLLL
LLLLLLLLLLLLLLLLLLLLLLLLLLLLLLLLLLLLLLLLLLLLLLLLLLLLLLLLLLLLLLLLLLLLLLLLLLLL
LLLLLLLLLLLLLLLLLLLLLLLLLLLLLLLLLLLLLLLLLLLLLLLLLLLLLLLLLLLLLLLLLLLLLLLLLLLL
LLLLLLLLLLLLLLLLLLLLLLLLLLLLLLLLLLLLLLLLLLLLLLLLLLLLLLLLLLLLLLLLLLLLLLLLLLLL
LLLLLLLLLLLLLLLLLLLLLLLLLLLLLLLLLLLLLLLLLLLLLLLLLLLLLLLLLLLLLLLLLLLLLLLLLLLL
LLLLLLLLLLLLLLLLLLLLLLLLLLLLLLLLLLLLLLLLLLLLLLLLLLLLLLLLLLLLLLLLLLLLLLLLLLLL
LLLLLLLLLLLLLLLLLLLLLLLLLLLLLLLLLLLLLLLLLLLLLLLLLLLLLLLLLLLLLLLLLLLLLLLLLLLL
ENDMAP

STAIR:(56,02),up
STAIR:(62,02),down

REGION:(00,00,75,19),lit,"ordinary"

MONSTER:'@',"blacksmith",(25,10),"Duri"

